111111101111111
100000000000001
1P0000011111101
1111000111E0001
100000C00000001
111111111111111