1111111111
1000000001
1000000001
1000000001
1000000001
1000000001
1C00000001
10000P0001
100000E001
1111111111