111111111111111
1CCCCCCCCCCCCC1
1PCCCCC111111C1
1111CCC111ECCC1
1CCCCCCCCCCCCC1
111111111111111