111111111111111
100000000000001
1P0O00011111101
1111000111E0001
100000000000001
111111111111111