111111111111111
100000000C00001
1000P00000000001
1000000000E0001
111111111111111