11111111111111111111
100000001E1000000001
10000000010000000001
1C000000000P00000001
11111111111111111111